111111111111111111111111111111111111111
1C010000000C11C010000000C11C010000000C1
100001111100110000111110011000011111001
1P0011E0000011P0011E0000011P0011E000001
111111101111011111110111111111111011111
1C010000000C11C010000000C11C010000000C1
100001111100110000111110011000011111001
1P0011E0000011P0011E0000011P0011E000001
110111111111111011111111111101111111111
111111111111111111111111111111111111111
1C010000000C11C010000000C11C010000000C1
100001111100110000111110011000011111001
1P0011E0000011P0011E0000011P0011E000001
111111101111111111110111111111111011111
111111101111111110110111111111111011111
1C010000000C11C010000000C11C010000000C1
100001111100110000111110011000011111001
1P0011E0000011P0011E0000011P0011E000001
111111111111111111111111111111111111111
111111111111111111111111111111111111111
1C010000000C11C010000000C11C010000000C1
100001111100110000111110011000011111001
1P0011E0000011P0011E0000011P0011E000001
111111111111111111111111111111111111111
111111111111111111111111111111111111111
1C010000000C11C010000000C11C010000000C1
100001111100110000111110011000011111001
1P0011E0000011P0011E0000011P0011E000001
111111111111111111111111111111111111111
111111111111111111111111111111111111111
1C010000000C11C010000000C11C010000000C1
100001111100110000111110011000011111001
1P0011E0000011P0011E0000011P0011E000001
111111111111111111111111111111111111111
111111111111111111111111111111111111111
1C010000000C11C010000000C11C010000000C1
100001111100110000111110011000011111001
1P0011E0000011P0011E0000011P0011E000001
111111111111111111111111111111111111111